?=?
*=*
kkya-=ッキャー
kkyu-=ッキュー
kkyo-=ッキョー
ssha-=ッシャー
sshu-=ッシュー
ssho-=ッショー
ccha-=ッチャー
cchu-=ッチュー
ccho-=ッチョー
ssya-=ッシャー
ssyu-=ッシュー
ssyo-=ッショー
ttya-=ッチャー
ttyu-=ッチュー
ttyo-=ッチョー
hhya-=ッヒャー
hhyu-=ッヒュー
hhyo-=ッヒョー
bbya-=ッビャー
bbyu-=ッビュー
bbyo-=ッビョー
mmya-=ッミャー
mmyu-=ッミュー
mmyo-=ッミョー
rrya-=ッリャー
rryu-=ッリュー
rryo-=ッリョー
ggya-=ッギャー
ggyu-=ッギュー
ggyo-=ッギョー
jja-=ッジャー
jju-=ッジュー
jjo-=ッジョー
zzya-=ッジャー
zzyu-=ッジュー
zzyo-=ッジョー
ddya-=ッヂャー
ddyu-=ッヂュー
ddyo-=ッヂョー
ppya-=ッピャー
ppyu-=ッピュー
ppyo-=ッピョー
kkya=ッキャ
kkyu=ッキュ
kkyo=ッキョ
ssha=ッシャ
sshu=ッシュ
ssho=ッショ
ccha=ッチャ
cchu=ッチュ
ccho=ッチョ
ssya=ッシャ
ssyu=ッシュ
ssyo=ッショ
ttya=ッチャ
ttyu=ッチュ
ttyo=ッチョ
hhya=ッヒャ
hhyu=ッヒュ
hhyo=ッヒョ
bbya=ッビャ
bbyu=ッビュ
bbyo=ッビョ
mmya=ッミャ
mmyu=ッミュ
mmyo=ッミョ
rrya=ッリャ
rryu=ッリュ
rryo=ッリョ
ggya=ッギャ
ggyu=ッギュ
ggyo=ッギョ
jja=ッジャ
jju=ッジュ
jjo=ッジョ
zzya=ッジャ
zzyu=ッジュ
zzyo=ッジョ
ddya=ッヂャ
ddyu=ッヂュ
ddyo=ッヂョ
ppya=ッピャ
ppyu=ッピュ
ppyo=ッピョ
kka-=ッカー
kki-=ッキー
kku-=ックー
kke-=ッケー
kko-=ッコー
ssa-=ッサー
sshi-=ッシー
ssi-=ッシー
ssu-=ッスー
sse-=ッセー
sso-=ッソー
tta-=ッター
cchi-=ッチー
ttsu-=ッツー
tti-=ッチー
ttu-=ッツー
tte-=ッテー
tto-=ットー
hha-=ッハー
hhi-=ッヒー
ffu-=ッフー
hhu-=ッフー
hhe-=ッヘー
hho-=ッホー
bba-=ッバー
bbi-=ッビー
bbu-=ッブー
bbe-=ッベー
bbo-=ッボー
mma-=ッマー
mmi-=ッミー
mmu-=ッムー
mme-=ッメー
mmo-=ッモー
yya-=ッヤー
yyu-=ッユー
yyo-=ッヨー
rra-=ッラー
rri-=ッリー
rru-=ッルー
rre-=ッレー
rro-=ッロー
wwa-=ッワー
wwo-=ッヲー
gga-=ッガー
ggi-=ッギー
ggu-=ッグー
gge-=ッゲー
ggo-=ッゴー
zza-=ッザー
jji-=ッジー
zzi-=ッジー
zzu-=ッズー
zze-=ッゼー
zzo-=ッゾー
dda-=ッダー
ddi-=ッヂー
ddu-=ッヅー
dde-=ッデー
ddo-=ッドー
ppa-=ッパー
ppi-=ッピー
ppu-=ップー
ppe-=ッペー
ppo-=ッポー
kka=ッカ
kki=ッキ
kku=ック
kke=ッケ
kko=ッコ
ssa=ッサ
sshi=ッシ
ssi=ッシ
ssu=ッス
sse=ッセ
sso=ッソ
tta=ッタ
cchi=ッチ
ttsu=ッツ
tti=ッチ
ttu=ッツ
tte=ッテ
tto=ット
hha=ッハ
hhi=ッヒ
ffu=ッフ
hhu=ッフ
hhe=ッヘ
hho=ッホ
bba=ッバ
bbi=ッビ
bbu=ッブ
bbe=ッベ
bbo=ッボ
mma=ッマ
mmi=ッミ
mmu=ッム
mme=ッメ
mmo=ッモ
yya=ッヤ
yyu=ッユ
yyo=ッヨ
rra=ッラ
rri=ッリ
rru=ッル
rre=ッレ
rro=ッロ
wwa=ッワ
wwo=ッヲ
gga=ッガ
ggi=ッギ
ggu=ッグ
gge=ッゲ
ggo=ッゴ
zza=ッザ
jji=ッジ
zzi=ッジ
zzu=ッズ
zze=ッゼ
zzo=ッゾ
dda=ッダ
ddi=ッヂ
ddu=ッヅ
dde=ッデ
ddo=ッド
ppa=ッパ
ppi=ッピ
ppu=ップ
ppe=ッペ
ppo=ッポ
kya-=キャー
kyu-=キュー
kyo-=キョー
sha-=シャー
shu-=シュー
sho-=ショー
cha-=チャー
chu-=チュー
cho-=チョー
sya-=シャー
syu-=シュー
syo-=ショー
tya-=チャー
tyu-=チュー
tyo-=チョー
hya-=ヒャー
hyu-=ヒュー
hyo-=ヒョー
bya-=ビャー
byu-=ビュー
byo-=ビョー
mya-=ミャー
myu-=ミュー
myo-=ミョー
rya-=リャー
ryu-=リュー
ryo-=リョー
gya-=ギャー
gyu-=ギュー
gyo-=ギョー
ja-=ジャー
ju-=ジュー
jo-=ジョー
zya-=ジャー
zyu-=ジュー
zyo-=ジョー
dya-=ヂャー
dyu-=ヂュー
dyo-=ヂョー
pya-=ピャー
pyu-=ピュー
pyo-=ピョー
kya=キャ
kyu=キュ
kyo=キョ
sha=シャ
shu=シュ
sho=ショ
cha=チャ
chu=チュ
cho=チョ
sya=シャ
syu=シュ
syo=ショ
tya=チャ
tyu=チュ
tyo=チョ
hya=ヒャ
hyu=ヒュ
hyo=ヒョ
bya=ビャ
byu=ビュ
byo=ビョ
mya=ミャ
myu=ミュ
myo=ミョ
rya=リャ
ryu=リュ
ryo=リョ
gya=ギャ
gyu=ギュ
gyo=ギョ
ja=ジャ
ju=ジュ
jo=ジョ
zya=ジャ
zyu=ジュ
zyo=ジョ
dya=ヂャ
dyu=ヂュ
dyo=ヂョ
pya=ピャ
pyu=ピュ
pyo=ピョ
nna-=ッナー
nni-=ッニー
nnu-=ッヌー
nne-=ッネー
nno-=ッノー
nna=ッナ
nni=ッニ
nnu=ッヌ
nne=ッネ
nno=ッノ
ka-=カー
ki-=キー
ku-=クー
ke-=ケー
ko-=コー
sa-=サー
shi-=シー
si-=シー
su-=スー
se-=セー
so-=ソー
ta-=ター
chi-=チー
tsu-=ツー
ti-=チー
tu-=ツー
te-=テー
to-=トー
na-=ナー
ni-=ニー
nu-=ヌー
ne-=ネー
no-=ノー
ha-=ハー
hi-=ヒー
fu-=フー
hu-=フー
he-=ヘー
ho-=ホー
ba-=バー
bi-=ビー
bu-=ブー
be-=ベー
bo-=ボー
ma-=マー
mi-=ミー
mu-=ムー
me-=メー
mo-=モー
ya-=ヤー
yu-=ユー
yo-=ヨー
ra-=ラー
ri-=リー
ru-=ルー
re-=レー
ro-=ロー
wa-=ワー
wo-=ヲー
ga-=ガー
gi-=ギー
gu-=グー
ge-=ゲー
go-=ゴー
za-=ザー
ji-=ジー
zi-=ジー
zu-=ズー
ze-=ゼー
zo-=ゾー
da-=ダー
di-=ヂー
du-=ヅー
de-=デー
do-=ドー
pa-=パー
pi-=ピー
pu-=プー
pe-=ペー
po-=ポー
ka=カ
ki=キ
ku=ク
ke=ケ
ko=コ
sa=サ
shi=シ
si=シ
su=ス
se=セ
so=ソ
ta=タ
chi=チ
tsu=ツ
ti=チ
tu=ツ
te=テ
to=ト
na=ナ
ni=ニ
nu=ヌ
ne=ネ
no=ノ
ha=ハ
hi=ヒ
fu=フ
hu=フ
he=ヘ
ho=ホ
ba=バ
bi=ビ
bu=ブ
be=ベ
bo=ボ
ma=マ
mi=ミ
mu=ム
me=メ
mo=モ
ya=ヤ
yu=ユ
yo=ヨ
ra=ラ
ri=リ
ru=ル
re=レ
ro=ロ
wa=ワ
wo=ヲ
ga=ガ
gi=ギ
gu=グ
ge=ゲ
go=ゴ
za=ザ
ji=ジ
zi=ジ
zu=ズ
ze=ゼ
zo=ゾ
da=ダ
di=ヂ
du=ヅ
de=デ
do=ド
pa=パ
pi=ピ
pu=プ
pe=ペ
po=ポ
xa=ァ
la=ァ
xi=ィ
li=ィ
xu=ゥ
lu=ゥ
xe=ェ
le=ェ
xo=ォ
lo=ォ
wi=ウィ
we=ウェ
wwi=ッウィ
wwe=ッウェ
va=ヴァ
vi=ヴィ
vu=ヴ
ve=ヴェ
vo=ヴォ
vva=ッヴァ
vvi=ッヴィ
vvu=ッヴ
vve=ッヴェ
vvo=ッヴォ
nn=ン
n'=ン
n=ン
a-=アー
i-=イー
u-=ウー
e-=エー
o-=オー
a=ア
i=イ
u=ウ
e=エ
o=オ
