?=?
*=*
kkya=っきゃ
kkyu=っきゅ
kkyo=っきょ
ssha=っしゃ
sshu=っしゅ
ssho=っしょ
ccha=っちゃ
cchu=っちゅ
ccho=っちょ
ssya=っしゃ
ssyu=っしゅ
ssyo=っしょ
ttya=っちゃ
ttyu=っちゅ
ttyo=っちょ
hhya=っひゃ
hhyu=っひゅ
hhyo=っひょ
bbya=っびゃ
bbyu=っびゅ
bbyo=っびょ
mmya=っみゃ
mmyu=っみゅ
mmyo=っみょ
rrya=っりゃ
rryu=っりゅ
rryo=っりょ
ggya=っぎゃ
ggyu=っぎゅ
ggyo=っぎょ
jja=っじゃ
jju=っじゅ
jjo=っじょ
zzya=っじゃ
zzyu=っじゅ
zzyo=っじょ
ddya=っぢゃ
ddyu=っぢゅ
ddyo=っぢょ
ppya=っぴゃ
ppyu=っぴゅ
ppyo=っぴょ
kka=っか
kki=っき
kku=っく
kke=っけ
kko=っこ
ssa=っさ
sshi=っし
ssi=っし
ssu=っす
sse=っせ
sso=っそ
tta=った
cchi=っち
ttsu=っつ
tti=っち
ttu=っつ
tte=って
tto=っと
hha=っは
hhi=っひ
ffu=っふ
hhu=っふ
hhe=っへ
hho=っほ
bba=っば
bbi=っび
bbu=っぶ
bbe=っべ
bbo=っぼ
mma=っま
mmi=っみ
mmu=っむ
mme=っめ
mmo=っも
yya=っや
yyu=っゆ
yyo=っよ
rra=っら
rri=っり
rru=っる
rre=っれ
rro=っろ
wwa=っわ
wwo=っを
gga=っが
ggi=っひ
ggu=っぐ
gge=っげ
ggo=っご
zza=っざ
jji=っじ
zzi=っじ
zzu=っず
zze=っぜ
zzo=っぞ
dda=っだ
ddi=っぢ
ddu=っづ
dde=っで
ddo=っど
ppa=っぱ
ppi=っぴ
ppu=っぷ
ppe=っぺ
ppo=っぽ
kya=きゃ
kyu=きゅ
kyo=きょ
sha=しゃ
shu=しゅ
sho=しょ
cha=ちゃ
chu=ちゅ
cho=ちょ
sya=しゃ
syu=しゅ
syo=しょ
tya=ちゃ
tyu=ちゅ
tyo=ちょ
hya=ひゃ
hyu=ひゅ
hyo=ひょ
bya=びゃ
byu=びゅ
byo=びょ
mya=みゃ
myu=みゅ
myo=みょ
rya=りゃ
ryu=りゅ
ryo=りょ
gya=ぎゃ
gyu=ぎゅ
gyo=ぎょ
ja=じゃ
ju=じゅ
jo=じょ
zya=じゃ
zyu=じゅ
zyo=じょ
dya=ぢゃ
dyu=ぢゅ
dyo=ぢょ
pya=ぴゃ
pyu=ぴゅ
pyo=ぴょ
nna=んあ
nni=んい
nnu=んう
nne=んえ
nno=んお
ka=か
ki=き
ku=く
ke=け
ko=こ
sa=さ
shi=し
si=し
su=す
se=せ
so=そ
ta=た
chi=ち
tsu=つ
ti=ち
tu=つ
te=て
to=と
na=な
ni=に
nu=ぬ
ne=ね
no=の
ha=は
hi=ひ
fu=ふ
hu=ふ
he=へ
ho=ほ
ba=ば
bi=び
bu=ぶ
be=べ
bo=ぼ
ma=ま
mi=み
mu=む
me=め
mo=も
ya=や
yu=ゆ
yo=よ
ra=ら
ri=り
ru=る
re=れ
ro=ろ
wa=わ
wo=を
ga=が
gi=ぎ
gu=ぐ
ge=げ
go=ご
za=ざ
ji=じ
zi=じ
zu=ず
ze=ぜ
zo=ぞ
da=だ
di=ぢ
du=づ
de=で
do=ど
pa=ぱ
pi=ぴ
pu=ぷ
pe=ぺ
po=ぽ
xa=ぁ
la=ぁ
xi=ぃ
li=ぃ
xu=ぅ
lu=ぅ
xe=ぇ
le=ぇ
xo=ぉ
lo=ぉ
wi=うぃ
we=うぇ
wwi=っうぃ
wwe=っうぇ
nn=ん
n'=ん
n=ん
aa=ああ
ii=いい
uu=うう
ee=ええ
ei=えい
oo=おお
ou=おう
oh=おう
a=あ
i=い
u=う
e=え
o=お
